%%%%%%%%%%%%%%%%%%%%
%    V             %
%                  %
%                  %
%                  %
%                  %
%                  % 
%           B      %
%                  %
%%%%%%%%%%%%%%%%%%%%
